00111111111111111111
10000000000000000001
10111101111111111100
10111101000000000001
10000000011111111100
10111110111000000111
10100010001000000001
10100010101000000001
10111110101111111111
10000000000000000000
10111111101111111101
10111001101111111101
10111101100001100000